20
15
16 16 16 16 16 16 16 16 16 16 16 16 16 16 16 16 16 16 16 16
16 10 0  0  9  16 10 0  0  0  0  0  0  0  0  0  0  0  9  16
16 2  4  0  0  0  0  2  0  0  0  0  0  0  0  5  0  0  0  16
16 14 14 0  0  0  0  18 0  3  0  0  0  0  0  18 0  0  55 16
16 0  0  0  0  16 0  0  0  18 0  0  21 0  0  0  0  0  18 16
16 0  0  0  21 16 5  0  0  0  0  0  17 0  0  5  0  0  0  16
16 0  0  0  14 16 14 0  0  0  0  0  0  0  0  18 0  0  0  16
16 0  0  0  0  0  0  0  0  4  0  0  0  0  0  0  0  0  0  16
16 0  0  0  0  4  0  0  0  18 0  0  0  0  1  2  0  0  0  16
16 0  0  0  0  14 0  0  0  0  0  0  0  0 14 14  0  0  6  16
16 0  0  0  0  16 0  0  0  2  0  0  0  0  3  0  0  0  18 16
16 0  0  0  0  16 21 0  0  14 3  0  0  0  14 0  0  0  0  16
16 0  0  0  3  16 2  0  0  16 14 6  1  7  16 0  0  14 0  16
16 8  1  2  14 16 14 1  5  16 16 14 14 16 16 5  6  1  21 16
16 14 14 14 16 16 16 14 14 16 16 16 16 16 16 14 14 14 14 16