15
15
16 16 16 16 16 16 16 16 16 16 16 16 16 16 16 
16 0  0  0  0  0  0  0  0  0  0  0  0  0  16   
16 0  0  0  0  0  0  0  0  0  0  0  0  0  16                                                      
16 0  0  0  0  0  0  0  0  0  0  0  0  0  16 
16 0  0  0  0  0  0  0  0  0  0  0  0  0  16 
16 0  0  0  0  0  0  0  0  0  0  0  0  0  16 
16 0  0  0  0  0  0  0  0  0  0  0  0  0  16  
16 0  0  0  0  0  0  0  0  0  0  0  0  0  16  
16 0  0  0  0  0  0  0  0  0  0  0  0  0  16  
16 0  0  0  0  0  0  0  0  0  0  0  0  0  16  
16 0  0  0  0  0  0  0  0  0  0  0  0  0  16  
16 0  0  0  0  0  0  0  0  0  0  0  0  0  16  
16 0  0  0  0  0  0  0  0  0  0  0  0  0  16  
16 0  0  0  0  0  0  0  0  0  0  0  0  55 16  
16 16 16 16 16 16 16 16 16 16 16 16 16 16 16 
